env-test_out-0	A lime key at column 9 row 7 is blocking a path to the target object. The agent's starting location has been moved to column 6 row 2.
env-test_out-1	The target object has been hidden inside a box. There is a pair of fireproof shoes at column 6 row 2. There is a walkable passage at column 2 row 4. A purple ball at column 8 row 7 is blocking a path to the target object.
env-test_out-2	The grid has been flipped along the vertical axis. The target object has been hidden inside a box. The color of the target object has been changed to lime. There is a pair of fire-proof shoes at column 2 row 1. The bridge at column 2 row 3 is no longer in the original state.
env-test_out-3	The color of the target object has been changed to saffron. A grey ball at column 4 row 8 is blocking a path to the target object. There is a walkable passage at column 5 row 5.
env-test_out-4	The target object has been hidden inside a box. There is a walkable passage at column 1 row 4. The bridge at column 3 row 4 is no longer in the original state. The bridge at column 6 row 8 is no longer in the original state. A lime ball at column 7 row 8 is blocking a path to the target object.
env-test_out-5	The color of the target object has been changed to grey. The target object has been hidden inside a box.
env-test_out-6	The target object has been hidden inside a box. The agent's starting location has been moved to column 1 row 7. There is a pair of fire-proof shoes at column 1 row 1. There is a walkable passage at column 5 row 6.
env-test_out-7	The agent's starting location has been moved to column 1 row 8. The color of the target object has been changed to grey. A new passage has been constructed at column 4 row 9. The target object has been hidden inside a box. There is a pair of fire-proof shoes at column 6 row 3.
env-test_out-8	A new closed door has been installed at column 7 row 5. A grey box at column 4 row 7 is blocking a path to the target object. The saffron key has been relocated to column 4 row 2. The color of the target object has been changed to lime. The target object has been hidden inside a box at column 4 row 7. There is a walkable passage at column 2 row 5.
env-test_out-9	A new damaged bridge has been constructed at column 5 row 7. There is a saffron ball at column 1 row 7 blocking a path to the target object. The bridge at column 5 row 7 is no longer in the original state. The agent's starting location has been moved to column 9 row 9.
env-test_out-10	The color of the target object has been changed to grey. The lava is safe to walk on.
env-test_out-11	The bridge at column 5 row 8 is no longer in the original state. There is a grey ball at column 6 row 8 blocking a path to the target object. The agent's starting location has been moved to column 7 row 7.
env-test_out-12	A new open lime door has been installed at column 5 row 9. There is a walkable passage at column 9 row 5. The target object has been hidden inside a box.
env-test_out-13	The grid has been flipped along the vertical axis. A new locked door has been installed at column 5 row 8. There is a walkable passage at column 7 row 4. A lime ball at column 4 row 8 is blocking a path to the target object. The agent's starting location has been moved to column 6 row 6.
env-test_out-14	The target object has been hidden inside a box. A new locked door has been installed at column 6 row 6. The door at column 6 row 6 is no longer in the original state. There is a walkable passage at column 4 row 9. A wall at column 9 row 4 is blocking a path to the target object.
env-test_out-15	The color of the target object has been changed to lime. A new closed lime door has been installed at column 7 row 8. A saffron key at column 7 row 2 is blocking a path to the target object. The door at column 3 row 6 is no longer in the original state. The agent's starting location has been moved to column 3 row 8.
env-test_out-16	The agent's starting location has been moved to column 1 row 7. The target object has been hidden inside a box. The grid has been flipped along the vertical axis. There is a pair of fire-proof shoes at column 2 row 1. The lava is safe to walk on. There is a walkable passage at column 7 row 8.
env-test_out-17	The agent's starting location has been moved to column 5 row 7. The target object has been hidden inside a box. The color of the target object has been changed to purple. The bridge at column 6 row 5 is no longer in the original state. There is a walkable passage at column 1 row 3. There is a pair of fireproof shoes at column 1 row 2.
env-test_out-18	The target object has been hidden inside a box. A new damaged bridge has been constructed at column 4 row 6. There is a walkable passage at column 1 row 6. There is a wall at column 2 row 3. There is a wall at column 7 row 5. There is a wall at column 7 row 2. There is a purple ball at column 8 row 9. The agent's starting location has been moved to column 3 row 7. The lava is safe to walk on.
env-test_out-19	The grid has been flipped along the vertical axis. The bridge at column 5 row 7 is no longer in the original state. There is a saffron ball at column 4 row 8 blocking a path to the target object.
env-test_out-20	The target object has been hidden inside a box. There is a walkable passage at column 4 row 3.
env-test_out-21	The color of the target object has been changed to saffron. The target object has been hidden inside a box. The agent's starting location has been moved to column 7 row 1. The bridge at column 2 row 6 is no longer in the original state. There is a walkable passage at column 3 row 6. There is a pair of fire-proof shoes at column 5 row 2.
env-test_out-22	The grid has been flipped along the vertical axis. The door at column 5 row 6 is no longer in the original state.
env-test_out-23	The color of the target object has been changed to grey. There is a lime ball at column 6 row 7. The target object has been hidden inside a box. The agent's starting location has been moved to column 9 row 9.
env-test_out-24	The agent's starting location has been moved to column 8 row 6. There is a pair of fire-proof shoes at column 5 and row 1. There is a walkable passage at column 6 row 7. The color of the target object has been changed to lime.
env-test_out-25	A {color} ball at column {col} row {row} is blocking a path to the target object. The ball at column 9 row 8 is no longer in the original position.
A {color} ball at column {col} row {row} is blocking a path to the target object. The ball at row 8 and column 1 is no longer in the original position.
A {color} ball at column {col} row {row} is blocking a path to the target object. The ball at column 6 row 8 is no longer in the original position.
A {state} bridge has been constructed at column {col} row {row}. The bridge at column 5 row 7 is now intact.
The agent's starting location has been moved to column 6 row 4.
There is a passage at column 3 row 6.
A pair of fire-proof shoes at column 2 row 5.
env-test_out-26	The target object has been hidden inside a box. A new damaged bridge has been constructed at column 5 row 6. There is a walkable passage at column 2 row 6. There is a pair of fireproof shoes at column 5 row 2.
env-test_out-27	A grey ball at column 6 row 9 is blocking a path to the target object. The target object has been hidden inside a box. The box is at column 2 row 6. The agent's starting location has been moved to column 2 row 1. The door at column 7 row 7 is no longer in the original state. A new closed door has been installed at column 7 row 8. The target object was changed to lime.
env-test_out-28	The grid has been flipped along the vertical axis. The door at column 5 row 7 is no longer in the original state. A new locked saffron door has been installed at column 7 row 5.
env-test_out-29	The target object has been hidden inside a box. The bridge at column 6 row 3 is no longer in the original state. The agent's starting location has been moved to column 9 row 4. There is a purple ball at column 8 row 2 blocking a path to the target object.
env-test_out-30	The agent's starting location has been moved to column 6 row 6. The target object has been hidden inside a box. A closed purple door has been installed at column 5 row 4. The door at column 4 row 5 is no longer in the original state. There is a walkable passage at column 4 row 6. A grey ball at column 3 row 5 is blocking a path to the target object.
env-test_out-31	The agent's starting location has been moved to column 9 row 9. The bridge at column 8 row 4 is no longer in the original state. There is a walkable passage at column 9 row 4. There is a saffron ball at column 1 row 1 blocking a path to the target object.
env-test_out-32	There is a saffron box at column 4 row 8, blocking a path to the grey ball. The target object has been hidden inside the saffron box.
env-test_out-33	The agent's starting location has been moved to column 8 row 8. There is a pair of fire-proof shoes at column 7 row 8. The bridge at column 6 row 8 is no longer in the original state. There is a walkable passage at column 7 row 5. A grey ball at column 5 row 8 is blocking a path to the target object.
env-test_out-34	The agent's starting location has been moved to column 7 row 3. The target object has been hidden inside a box. The lava is safe to walk on.
env-test_out-35	The grid has been flipped along the vertical axis. The color of the target object has been changed to lime. The target object has been hidden inside a box. A saffron ball at column 2 row 1 is blocking a path to the target object. The agent's starting location has been moved to column 8 row 9.
env-test_out-36	The agent's starting location has been moved to column 4 row 8. There is a saffron ball at column 6 and row 2 blocking a path to the target object. The color of the target object has been changed to lime.
env-test_out-37	The grid has been flipped along the vertical axis. The bridge at column 7 row 6 is no longer in the original state. There is a pair of fireproof shoes at column 1 row 1.
env-test_out-38	The grey ball has been hidden inside a box. There is a pair of fireproof shoes at column 6 row 1.
env-test_out-39	The target object has been hidden inside a box. The color of the target object has been changed to lime. The agent's starting location has been moved to column 8 row 8. There is a damaged bridge at column 2 row 6.
env-test_out-40	The grid has been flipped along the vertical axis. The door at column 2 row 6 is no longer in the original state. The target object has been hidden inside a box. There is a walkable passage at column 6 row 8.
env-test_out-41	The target object has been hidden inside a box. A new locked door has been installed at column 6 row 5. A purple box at column 1 row 5 is blocking a path to the target object.
env-test_out-42	The agent's starting location has been moved to column 2 row 6. The target object has been hidden inside a box. A lime ball at column 3 row 4 is blocking a path to the target object. A new closed purple door has been installed at column 4 row 4. The door at column 4 row 7 is no longer in the original state. The color of the target object has been changed to saffron.
env-test_out-43	A new intact bridge has been constructed at column 7 row 3. There is a walkable passage at column 6 row 8. There is a pair of fireproof shoes at column 3 row 1.
env-test_out-44	The target object has been hidden inside a box.
env-test_out-45	The target object has been hidden inside a box. A grey ball at column 5 row 8 is blocking a path to the target object. There is a pair of fire-proof shoes at column 4 row 2.
env-test_out-46	The target object has been hidden inside a box. A closed saffron door has been installed at column 4 row 4. A wall at column 2 row 6 is blocking a path to the target object. A grey ball at column 1 row 9 is blocking a path to the target object. The door at column 3 row 7 is no longer in the original state.
env-test_out-47	The grid has been flipped along the vertical axis. The target object has been hidden inside a box. A new locked door has been installed at column 4 row 5. There is a walkable passage at column 3 row 3.
env-test_out-48	The target object has been hidden inside a box. There is a walkable passage at column 6 row 8. A new intact bridge has been constructed at column 8 row 6. A lime ball at column 8 row 5 is blocking a path to the target object.
env-test_out-49	The color of the target object has been changed to grey. The target object has been hidden inside a box. The agent's starting location has been moved to column 3 row 9.
env-test_out-50	The target object has been hidden inside a box. The agent's starting location has been moved to column 2 row 5. The door at column 2 row 4 is no longer in the original state. A new closed door has been installed at column 4 row 10.
env-test_out-51	The color of the target object has been changed to grey. A new closed grey door has been installed at column 6 row 5. The agent's starting location has been moved to column 3 row 8.
env-test_out-52	The agent's starting location has been moved to column 1 row 8. The target object has been hidden inside a box. A purple ball at column 8 row 5 is blocking a path to the target object. A damaged bridge has been constructed at column 7 row 5. There is a pair of fireproof shoes at column 9 row 3.
env-test_out-53	A lime ball at column 2 row 6 is blocking a path to the target object. There is a damaged bridge at column 7 row 3. There is a purple ball at column 9 row 7.
env-test_out-54	The color of the target object has been changed to saffron. The bridge at column 4 row 6 is no longer in the original state. There is a walkable passage at column 5 row 6. The target object has been hidden inside a box. A new intact bridge has been constructed at column 9 row 6.
env-test_out-55	The agent's starting location has been moved to column 1 row 8. A pair of fire-proof shoes at column 7 row 1. The target object has been hidden inside a box. A new damaged bridge has been constructed at column 7 row 4. A saffron ball at column 3 row 7 is blocking a path to the target object. There is a lime box at column 4 row 2.
env-test_out-56	The grid has been flipped along the vertical axis. The target object has been hidden inside a box. The bridge at column 6 row 7 is no longer in the original state. A new damaged bridge has been constructed at column 2 row 6. A grey ball at column 7 row 7 is blocking a path to the target object. There is a walkable passage at column 6 row 8.
env-test_out-57	The grid has been flipped along the vertical axis. The color of the target object has been changed to purple. A new damaged bridge has been constructed at column 4 row 7. A grey ball at column 3 row 7 is blocking a path to the target object. There is a pair of fire-proof shoes at column 3 row 4. There is a walkable passage at column 8 row 3. The lava is safe to walk on.
env-test_out-58	The agent's starting location has been moved to column 9 row 8. The color of the target object has been changed to lime. The bridge at column 8 row 6 is no longer in the original state. There is a walkable passage at column 6 row 9. There is a pair of fire-proof shoes at column 4 row 5.
env-test_out-59	The agent's starting location has been moved to column 5 row 8. The grid has been flipped along the vertical axis. The target object has been hidden inside a box. The color of the target object has been changed to lime. A new damaged bridge has been constructed at column 7 row 7. There is a walkable passage at column 6 row 6. There is a pair of fireproof shoes at column 8 row 6.
env-test_out-60	The target object has been hidden inside a box. The door at column 6 row 5 is no longer in the original state. There is a walkable passage at column 6 row 6. A grey ball at column 5 row 9 is blocking a path to the target object.
env-test_out-61	The color of the target object has been changed to saffron. A closed grey door has been installed at column 6 row 8. The agent's starting location has been moved to column 8 row 4.
env-test_out-62	The saffron box at column 7 row 8 is blocking a path to the target object. The bridge at column 5 row 7 is no longer in the original state. The bridge at column 5 row 8 is no longer in the original state. There is a walkable passage at column 5 row 9. The agent's starting location has been moved to column 5 row 5.
env-test_out-63	The grid has been flipped along the vertical axis. A new closed lime door has been installed at column 5 row 6. The color of the target object has been changed to saffron. The target object has been hidden inside a box. The agent's starting location has been moved to column 3 row 9. There is a walkable passage at column 5 row 7.
env-test_out-64	The agent's starting location has been moved to column 1 row 4. The color of the target object has been changed to lime. The target object has been hidden inside a box. There is a pair of fireproof shoes at column 5 row 1. There is a walkable passage at column 5 row 3.
env-test_out-65	The agent's starting location has been moved to column 9 row 6. A new damaged bridge has been constructed at column 6 row 3. There is a walkable passage at column 5 row 3. A grey ball at column 6 row 2 is blocking a path to the target object.
env-test_out-66	The grid has been flipped along the vertical axis. The bridge at column 3 row 3 is no longer in the original state. A new damaged bridge has been constructed at column 2 row 3. There is a walkable passage at column 6 row 6.
env-test_out-67	The agent's starting location has been moved to column 8 row 7. A new open saffron door has been installed at column 4 row 8. There is a walkable passage at column 6 row 6. A lime key was hidden inside a box. A purple ball at column 8 row 5 is blocking a path to the target object.
env-test_out-68	The agent's starting location has been moved to column 1 row 9. The color of the target object has been changed to grey. The grid has been flipped along the vertical axis. A closed grey door has been installed at column 3 row 6. There is a lime key at column 1 row 8. There is a wall at column 6 row 5. There is a wall at column 8 row 8. There is a passage at column 4 row 6.
env-test_out-69	The agent's starting location has been moved to column 8 row 2. A new closed lime door has been installed at column 6 row 5. A new locked lime door has been installed at column 7 row 4. The color of the target object has been changed to grey. There is a walkable passage at column 6 row 8.
env-test_out-70	A new intact bridge has been constructed at column 7 row 8. The target object has been hidden inside a box. The grid has been flipped along the vertical axis. The color of the target object has been changed to lime. 
env-test_out-71	The agent's starting location has been moved to column 5 row 1. A new locked door has been installed at column 8 row 3. A purple ball at column 8 row 2 is blocking a path to the target object. The grid has been flipped along the vertical axis. There is a walkable passage at column 7 row 3.
env-test_out-72	There is a walkable passage at column 4 row 8. The target object has been hidden inside a box.
env-test_out-73	The grid has been flipped along the vertical axis. There is a walkable passage at column 4 row 4. A new open door has been installed at column 2 row 4. A grey ball at column 2 row 3 is blocking a path to the target object.
env-test_out-74	The target object has been hidden inside a box. There is a pair of fire-proof shoes at column 9 row 1.
env-test_out-75	The grid has been flipped along the vertical axis. The agent's starting location has been moved to column 2 row 4. There is a saffron ball at column 9 row 4.
env-test_out-76	A lime key at column 6 row 1 is blocking a path to the target object. The target object has been hidden inside a box. There is a walkable passage at column 3 row 8. 
env-test_out-77	The target object has been hidden inside a box. A grey ball at column 2 row 9 is blocking a path to the target object. There is a walkable passage at column 6 row 4.
env-test_out-78	The target object has been hidden inside a box. There is a pair of fire-proof shoes at column 1 row 9.
env-test_out-79	The target object has been hidden inside a box. The agent's starting location has been moved to column 4 row 9. The bridge at column 3 row 6 is no longer in the original state. The color of the target object has been changed to saffron. There is a pair of fire-proof shoes at column 8 row 5. There is a walkable passage at column 5 row 9.
env-test_out-80	The target object has been hidden inside a box. The agent's starting location has been moved to column 2 row 8. The door at column 7 row 6 is no longer in the original state. A purple ball at column 8 row 6 is blocking a path to the target object.
env-test_out-81	The grid has been flipped along the vertical axis. The target object has been hidden inside a box. The grid has been flipped along the vertical axis. The bridge at column 4 row 7 is no longer in the original state. There is a damaged bridge at column 3 row 6. There is a pair of fire-proof shoes at column 2 row 8.
env-test_out-82	The agent's starting location has been moved to column 7 row 7. The door at column 7 row 6 is no longer in the original state. The grid has been flipped along the vertical axis.
env-test_out-83	The agent's starting location has been moved to column 7 row 9. A new walkable passage has been constructed at column 6 row 6.
env-test_out-84	There is a grey ball at column 8 and row 2 blocking a path to the target object. The door at column 8 and row 3 is no longer in the original state. A new closed saffron door has been installed at column 6 and row 5.
env-test_out-85	A new closed door has been installed at column 3 row 5. The target object has been hidden inside a box. There is a walkable passage at column 7 row 9.
env-test_out-86	The color of the target object has been changed to saffron. The agent's starting location has been moved to column 2 row 8. The grid has been flipped along the vertical axis. There is a walkable passage at column 6 row 6. A damaged bridge has been constructed at column 3 row 5.
env-test_out-87	The agent's starting location has been moved to column 8 row 7. The grid has been flipped along the vertical axis. The bridge at column 3 row 5 is no longer in the original state. There is a walkable passage at column 3 row 9.
env-test_out-88	The door at column 3 row 6 is no longer in the original state. A locked purple door has been installed at column 3 row 8. The agent's starting location has been moved to column 6 row 9. There is a walkable passage at column 3 row 9. A purple box at column 6 row 7 is blocking a path to the target object.
env-test_out-89	A saffron ball at column 9 row 3 is blocking a path to the target object. The target object has been hidden inside a box. The agent's starting location has been moved to column 7 row 7.
env-test_out-90	The target object has been hidden inside a box. The agent's starting location has been moved to column 6 row 5. The bridge at column 4 row 6 is no longer in the original state. There is a walkable passage at column 7 row 3. There is a pair of fire-proof shoes at column 2 row 6.
env-test_out-91	The color of the target object has been changed to purple. The target object has been hidden inside a box. The bridge at column 2 row 4 is no longer in the original state. There is a walkable passage at column 5 row 8. The agent's starting location has been moved to column 3 row 9. There is a pair of fire-proof shoes at column 8 row 9.
env-test_out-92	The grid has been flipped along the vertical axis. There is a walkable passage at column 6 row 5. The door at column 4 row 5 is no longer in the original state. The door at column 7 row 9 is no longer in the original state. The agent's starting location has been moved to column 4 row 7.
env-test_out-93	The target object has been hidden inside a box. The agent's starting location has been moved to column 1 row 8. A damaged bridge has been constructed at column 5 row 7. A purple ball at column 6 row 7 is blocking a path to the target object. There is a walkable passage at column 5 row 8. There is a pair of fireproof shoes at column 8 row 1.
env-test_out-94	The agent's starting location has been moved to column 3 row 4. The grid has been flipped along the vertical axis. The target object has been hidden inside a box.
env-test_out-95	The grid has been flipped along the vertical axis. The color of the target object has been changed to grey. A new locked door has been installed at column 7 row 6. The target object has been hidden inside a box. The box at column 9 row 9 is no longer in the original state. There is a walkable passage at column 5 row 8.
env-test_out-96	The color of the target object has been changed to lime. The target object has been hidden inside a box. A pair of fireproof shoes at column 2 row 2.
env-test_out-97	The grid has been flipped along the vertical axis. There is a walkable passage at column 4 row 7. A new damaged bridge has been constructed at column 4 row 6. The agent's starting location has been moved to column 8 row 3.
env-test_out-98	The target object has been hidden inside a box. A new closed lime door has been installed at column 5 row 6. There is a walkable passage at column 5 row 7. There are walls from column 1 row 4 to column 5 row 4. There is a wall at column 5 row 5. There are walls from column 5 row 8 to column 5 row 10.
env-test_out-99	The target object has been hidden inside a box. The agent's starting location has been moved to column 3 row 2. There is a pair of fire-proof shoes at column 2 row 6.
