env-test_out-0	The door at column 5 row 5 is no longer in the original state. The grid has been flipped along the vertical axis.
env-test_out-1	The grid has been flipped along the vertical axis. The color of the target object has been changed to lime. The target object has been hidden inside a box. The agent's starting location has been moved to column 5 row 1. There is a walkable passage at column 2 row 4.
env-test_out-2	The bridge at column 2 row 3 is no longer in the original state. The lime ball has been hidden inside a box. The agent's starting location has been moved to column 1 row 6.
env-test_out-3	The color of the target object has been changed to saffron. The agent's starting location has been moved to column 3 row 4. There is a walkable passage at column 5 row 5.
env-test_out-4	The grid has been flipped along the vertical axis. A new intact bridge has been constructed at column 3 row 4. A lime ball at column 7 row 8 is blocking a path to the target object. The target object has been hidden inside a box. The agent's starting location has been moved to column 2 row 7.
env-test_out-5	The target object has been hidden inside a box. The door at column 2 row 3 is no longer in the original state. The door at column 7 row 6 is no longer in the original state. The agent's starting location has been moved to column 7 row 1.
env-test_out-6	The target object has been hidden inside a box. The agent's starting location has been moved to column 1 row 7. The lava is safe to walk on.
env-test_out-7	The grid has been flipped along the vertical axis. The target object has been hidden inside a box. There is a walkable passage at column 4 row 9. The agent's starting location has been moved to column 1 row 8.
env-test_out-8	The grid has been flipped along the vertical axis. The door at column 7 row 5 is no longer in the original state. A new open door has been installed at column 7 row 5. There is a walkable passage at column 3 row 5. The lime ball at column 8 row 5 is blocking a path to the target object. There is a grey box at column 4 row 7.
env-test_out-9	The target object has been hidden inside a box. The bridge at column 5 row 7 is no longer in the original state. A new intact bridge has been constructed at column 4 row 7.
env-test_out-10	The color of the target object has been changed to lime. There is a saffron ball at column 2 row 1 blocking a path to the target object. The agent's starting location has been moved to column 4 row 3.
env-test_out-11	The bridge at column 5 row 8 is no longer in the original state. There is a walkable passage at column 3 row 8.
env-test_out-12	The target object has been hidden inside a box. The door at column 5 row 9 is no longer in the original state. The color of the target object has been changed to saffron.
env-test_out-13	The color of the target object has been changed to blue. The lime ball at column 3 row 8 is blocking a path to the target object. The locked purple door at column 5 row 8 is no longer in the original state. The agent's starting location has been moved to column 6 row 6.
env-test_out-14	The color of the target object has been changed to blue. The door at column 6 row 6 is no longer in the original state. There is a walkable passage at column 4 row 9. The agent's starting location has been moved to column 5 row 3.
env-test_out-15	The door at column 3 row 6 is no longer in the original state. The lime ball at column 8 row 8 has disappeared. The grid has been flipped along the vertical axis.
env-test_out-16	The color of the target object has been changed to lime. The bridge at column 2 row 5 is no longer in the original state. A new intact bridge has been constructed at column 6 row 8.
env-test_out-17	The color of the target object has been changed to lime. The agent's starting location has been moved to column 5 row 5.
env-test_out-18	The agent's starting location has been moved to column 7 row 8. The bridge at column 4 row 6 is no longer in the original state. The grey box at column 2 row 8 has been hidden. There is a walkable passage at column 3 row 6.
env-test_out-19	The color of the target object has been changed to saffron. The bridge at column 5 row 7 is no longer in the original state. A new intact bridge has been constructed at column 9 row 8. The agent's starting location has been moved to column 1 row 6.
env-test_out-20	The color of the target object has been changed to saffron. The target object has been hidden inside a box. The agent's starting location has been moved to column 2 row 7.
env-test_out-21	The color of the target object has been changed to purple. There is a walkable passage at column 3 row 6. The bridge at column 2 row 6 is no longer in the original state. The agent's starting location has been moved to column 7 row 1.
env-test_out-22	The target object has been hidden inside a box. The door at column 5 row 6 is no longer in the original state.
env-test_out-23	The target object has been hidden inside a box. The door at column 5 row 7 is no longer in the original state. A new open door has been installed at column 5 row 7. There is a walkable passage at column 2 row 4. The agent's starting location has been moved to column 9 row 9.
env-test_out-24	The bridge at column 8 row 3 is no longer in the original state. A saffron ball at column 4 row 8 is blocking a path to the target object. The agent's starting location has been moved to column 8 row 6.
env-test_out-25	The bridge at column 5 row 8 is no longer in the original state. The color of the target object has been changed to lime. The target object has been hidden inside a box.
env-test_out-26	The target object has been hidden inside a box. The bridge at column 5 row 6 is no longer in the original state.
env-test_out-27	The target object has been hidden inside a box. The door at column 7 row 8 is no longer in the original state. There is a walkable passage at column 6 row 3.
env-test_out-28	The color of the target object has been changed to blue. The door at column 7 row 5 is no longer in the original state. The grid has been flipped along the vertical axis.
env-test_out-29	The grid has been flipped along the vertical axis. The lime ball has been hidden inside a box. The bridge at column 6 row 3 is no longer in the original state. There is a walkable passage at column 6 row 4.
env-test_out-30	The door at column 5 row 4 is no longer in the original state. There is a walkable passage at column 4 row 6. The color of the target object has been changed to grey.
env-test_out-31	The agent's starting location has been moved to column 9 row 9. The target object has been hidden inside a box. The bridge at column 8 row 4 is no longer in the original state.
env-test_out-32	The agent's starting location has been moved to column 4 row 9. A new intact bridge has been constructed at column 5 row 7. The grey ball has been hidden inside a saffron box.
env-test_out-33	The bridge at column 6 row 8 is no longer in the original state. A new intact bridge has been constructed at column 8 row 9. The color of the target object has been changed to grey. The agent's starting location has been moved to column 8 row 8.
env-test_out-34	The target object has been hidden inside a box. A grey ball at column 7 row 2 is blocking a path to the target object. The agent's starting location has been moved to column 7 row 3.
env-test_out-35	The target object has been hidden inside a box. The grid has been flipped along the vertical axis. The lava is safe to walk on. The agent's starting location has been moved to column 8 row 9.
env-test_out-36	The color of the target object has been changed to green. The grid has been flipped along the vertical axis.
env-test_out-37	The bridge at column 7 row 6 is no longer in the original state. A new intact bridge has been constructed at column 7 row 8. The target object has been hidden inside a box. The color of the target object has been changed to lime.
env-test_out-38	The agent's starting location has been moved to column 6 row 4. The bridge at column 5 row 9 is no longer in the original state. The color of the target object has been changed to grey. The target object has been hidden inside a box.
env-test_out-39	The target object has been hidden inside a box. The bridge at column 2 row 6 is no longer in the original state. There is a walkable passage at column 4 row 6. The agent's starting location has been moved to column 1 row 9.
env-test_out-40	The door at column 4 row 6 is no longer in the original state. A new closed door has been installed at column 8 row 6. There is a walkable passage at column 6 row 8. The target object has been hidden inside a box.
env-test_out-41	The target object has been hidden inside a box. A new locked door has been installed at column 6 row 5. The color of the target object has been changed to grey. The agent's starting location has been moved to column 2 row 7.
env-test_out-42	The door at column 4 row 4 is no longer in the original state. The target object has been hidden inside a box. There is a walkable passage at column 4 row 4.
env-test_out-43	The color of the target object has been changed to lime. The target object has been hidden inside a box. The agent's starting location has been moved to column 4 row 8.
env-test_out-44	The target object has been hidden inside a box. The door at column 9 row 5 is no longer in the original state.
env-test_out-45	The target object has been hidden inside a box. The grid has been flipped along the vertical axis.
env-test_out-46	The saffron ball has disappeared. The door at column 4 row 4 is no longer in the original state. A new closed door has been installed at column 4 row 4.
env-test_out-47	The target object has been hidden inside a box. The door at column 4 row 5 is no longer in the original state. The grid has been flipped along the vertical axis.
env-test_out-48	The color of the target object has been changed to grey. The target object has been hidden inside a box. There is a walkable passage at column 6 row 8.
env-test_out-49	The door at column 6 row 6 is no longer in the original state. A new closed door has been installed at column 9 row 9. The agent's starting location has been moved to column 9 row 9.
env-test_out-50	The target object has been hidden inside a box. The door at column 2 row 4 is no longer in the original state. There is a walkable passage at column 1 row 3. The agent's starting location has been moved to column 2 row 5.
env-test_out-51	The door at column 7 row 5 is no longer in the original state. The target object has been hidden inside a box.
env-test_out-52	The target object has been hidden inside a box. The bridge at column 7 row 5 is no longer in the original state. The agent's starting location has been moved to column 1 row 8. There is a pair of fire-proof shoes at column 9 row 3.
env-test_out-53	The color of the target object has been changed to lime. The bridge at column 7 row 3 is no longer in the original state. There is a walkable passage at column 9 row 3. The agent's starting location has been moved to column 2 row 6.
env-test_out-54	The color of the target object has been changed to lime. The target object has been hidden inside a box. The bridge at column 4 row 6 is no longer in the original state. There is a walkable passage at column 5 row 6.
env-test_out-55	The grid has been flipped along the vertical axis. The bridge at column 7 row 4 is no longer in the original state. The lava is safe to walk on.
env-test_out-56	The target object has been hidden inside a box. The bridge at column 2 row 6 is no longer in the original state. There is a walkable passage at column 6 row 8.
env-test_out-57	The target object has been hidden inside a box. A damaged bridge has been constructed at column 4 row 7. The lava is safe to walk on.
env-test_out-58	The grid has been flipped along the vertical axis. The target object has been hidden inside a box. The agent's starting location has been moved to column 9 row 8. The bridge at column 8 row 6 is no longer in the original state. There is a walkable passage at column 6 row 9.
env-test_out-59	The bridge at column 7 row 7 is no longer in the original state. The color of the target object has been changed to lime. The target object has been hidden inside a box. The agent's starting location has been moved to column 5 row 8. There is a walkable passage at column 6 row 6.
env-test_out-60	The door at column 6 row 5 is no longer in the original state. The grid has been flipped along the vertical axis. The target object has been hidden inside a box.
env-test_out-61	The color of the target object has been changed to purple. The door at column 6 row 8 is no longer in the original state. A new locked door has been installed at column 6 row 8. There is a lime ball at column 7 row 4 blocking a path to the target object.
env-test_out-62	The bridge at column 5 row 7 is no longer in the original state. The saffron ball has been hidden inside a box. The agent's starting location has been moved to column 3 row 3.
env-test_out-63	The door at column 5 row 6 is no longer in the original state. A new closed door has been installed at column 9 row 6. The purple box at column 1 row 6 has disappeared. The color of the target object has been changed to blue.
env-test_out-64	The color of the target object has been changed to lime. The agent's starting location has been moved to column 3 row 1. There is a walkable passage at column 5 row 3.
env-test_out-65	The target object has been hidden inside a box. The bridge at column 6 row 3 is no longer in the original state. There is a walkable passage at column 5 row 3.
env-test_out-66	The target object has been hidden inside a box. The bridge at column 2 row 3 is no longer in the original state. There is a walkable passage at column 6 row 6.
env-test_out-67	The color of the target object has been changed to green. The target object has been hidden inside a box.
env-test_out-68	The door at column 7 row 6 is no longer in the original state. A new closed door has been installed at column 3 row 6. The gray ball has been hidden inside a box. There is a walkable passage at column 4 row 6.
env-test_out-69	The door at column 6 row 5 is no longer in the original state. The grid has been flipped along the vertical axis. The target object has been hidden inside a box.
env-test_out-70	The color of the target object has been changed to purple. The bridge at column 2 row 6 is no longer in the original state. The agent's starting location has been moved to column 6 row 9. There is a walkable passage at column 6 row 8.
env-test_out-71	The grid has been flipped along the vertical axis. The color of the target object has been changed to purple. A new locked door has been installed at column 8 row 3. A purple ball at column 8 row 2 is blocking a path to the target object.
env-test_out-72	The target object has been hidden inside a box. A new locked door has been installed at column 8 row 6. The door at column 6 row 6 is no longer in the original state.
env-test_out-73	The target object has been hidden inside a box. The door at column 2 row 4 is no longer in the original state. There is a walkable passage at column 4 row 4. The agent's starting location has been moved to column 3 row 7.
env-test_out-74	The color of the target object has been changed to saffron. The target object has been hidden inside a box. The bridge at column 6 row 8 is no longer in the original state.
env-test_out-75	The color of the target object has been changed to saffron. A new intact bridge has been constructed at column 4 row 6.
env-test_out-76	The color of the target object has been changed to grey. The door at column 3 row 7 is no longer in the original state. The target object has been hidden inside a box.
env-test_out-77	The target object has been hidden inside a box. There is a walkable passage at column 6 row 4.
env-test_out-78	The target object has been hidden inside a box. The grid has been flipped along the vertical axis. A new intact bridge has been constructed at column 6 row 9.
env-test_out-79	The bridge at column 3 row 6 is no longer in the original state. The agent's starting location has been moved to column 4 row 9. The lava is safe to walk on.
env-test_out-80	The color of the target object has been changed to lime. The target object has been hidden inside a box. The door at column 7 row 6 is no longer in the original state. There is a walkable passage at column 6 row 8.
env-test_out-81	The target object has been hidden inside a box. The bridge at column 3 row 6 is no longer in the original state. A new damaged bridge has been constructed at column 4 row 7. There is a walkable passage at column 4 row 8. The agent's starting location has been moved to column 2 row 7.
env-test_out-82	The agent's starting location has been moved to column 7 row 7. The door at column 5 row 7 is no longer in the original state. The color of the target object has been changed to grey. The target object has been hidden inside a box.
env-test_out-83	The color of the target object has been changed to lime. The bridge at column 5 row 6 is no longer in the original state. There is a walkable passage at column 6 row 6.
env-test_out-84	The door at column 6 row 5 is no longer in the original state. A new closed door has been installed at column 6 row 5. The agent's starting location has been moved to column 8 row 1.
env-test_out-85	The color of the target object has been changed to saffron. A saffron ball at column 8 row 9 is blocking a path to the target object. The target object has been hidden inside a box. The door at column 3 row 5 is no longer in the original state.
env-test_out-86	The grid has been flipped along the vertical axis. The target object has been hidden inside a box. The bridge at column 3 row 5 is no longer in the original state. There is a walkable passage at column 6 row 6. The agent's starting location has been moved to column 2 row 8.
env-test_out-87	The bridge at column 3 row 5 is no longer in the original state. There is a wall at column 3 and row 7. A grey ball at column 3 row 9 is blocking a path to the target object.
env-test_out-88	The target object has been hidden inside a box. The door at column 3 row 6 is no longer in the original state. The agent's starting location has been moved to column 6 row 9.
env-test_out-89	The target object has been hidden inside a box. The bridge at column 7 row 6 is no longer in the original state. There is a pair of fire-proof shoes at column 2 row 8.
env-test_out-90	The target object has been hidden inside a box. The bridge at column 4 row 8 is no longer in the original state. The agent's starting location has been moved to column 6 row 5. There is a walkable passage at column 7 row 3. There is a pair of fire-proof shoes at column 2 row 6.
env-test_out-91	The bridge at column 2 row 4 is no longer in the original state. There is a walkable passage at column 5 row 8. The grey target object has been hidden inside a box.
env-test_out-92	The saffron ball has been hidden inside a box. The door at column 7 row 9 is no longer in the original state. A new locked door has been installed at column 2 row 8. There is a walkable passage at column 6 row 5.
env-test_out-93	The agent's starting location has been moved to column 8 row 9. The target object has been hidden inside a box.
env-test_out-94	The door at column 4 row 5 is no longer in the original state. The grid has been flipped along the vertical axis. A new closed door has been installed at column 4 row 8. There is a walkable passage at column 1 row 3. A lime ball at column 5 row 7 is blocking a path to the target object.
env-test_out-95	The door at column 7 row 6 is no longer in the original state. A new locked door has been installed at column 9 row 6. The grey ball at column 7 row 5 has been hidden inside a box.
env-test_out-96	The color of the target object has been changed to lime. The target object has been hidden inside a box. The agent's starting location has been moved to column 9 row 8.
env-test_out-97	The bridge at column 4 row 6 is no longer in the original state. The grey ball at column 8 row 8 has been hidden inside a box.
env-test_out-98	The door at column 5 row 6 is no longer in the original state. A new closed door has been installed at column 5 row 6. There is a walkable passage at column 5 row 7. There is a saffron ball at column 1 row 2 blocking a path to the target object. The agent's starting location has been moved to column 7 row 1.
env-test_out-99	The target object has been hidden inside a box. The agent's starting location has been moved to column 3 row 2.
