env-test_out-0	 ?  (fill in the answer)
env-test_out-1	 ?  (Please fill in the answer)
env-test_out-2	 (write your answer here)
env-test_out-3	 ?  (Please fill in the answer)
env-test_out-4	 ?  (Please fill in the answer)
env-test_out-5	 ?  (Please fill in the answer)
env-test_out-6	 ?  (fill in the answer)
env-test_out-7	 ?  (Please fill in the answer)
env-test_out-8	 ?  (fill in the answer)
env-test_out-9	 ?  (fill in the answer)
env-test_out-10	 ?  (fill in the answer)
env-test_out-11	 The bridge at column 5 row 8 is no longer in the original state. A grey ball at column 6 row 8 is blocking a path to the target object.
env-test_out-12	 ?  (Please fill in the answer)
env-test_out-13	 ?  (fill in the answer)
env-test_out-14	 ?  (fill in the answer)
env-test_out-15	 ?  ?  ?  ?  ?  ?  ?  ?  ?  ?  ?  ?  ?  ?  ?  ?  ?  ?  ?  ?  ?  ?  ?  ?  ?  ?  ?  ?  ?  ?  ?  ?  ?  ?  ?  ?  ?  ?  ?  ?  ?  ?  ?  ?  ?  ?  ?  ?  ?  ?  ?  ?  ?  ?  ?  ?  ?  ?  ?  ?  ?  ?  ?  ?  ?  ?  ?  ?  ?  ?  ?  ?  ?  ?  ?  ?  ?  ?  ?  ?  ?  ?  ?  ?  ?  ?  ?  ?  ?  ?  ?  ?  ?  ?  ?  ?  ?  ?  ?  ?  ?  ?  ?  ?  ?  ?  ?  ?  ?  ?  ?  ?  ?  ?  ?  ?  ?  ?  ?  ?  ?  ?  ?  ?  ? 
env-test_out-16	 ?  (Please fill in the answer)
env-test_out-17	 ?  (Please fill in the answer)
env-test_out-18	 ?  (fill in the answer)
env-test_out-19	 (write your answer here)
env-test_out-20	 ?  ?  ?  ?  ?  ?  ?  ?  ?  ?  ?  ?  ?  ?  ?  ?  ?  ?  ?  ?  ?  ?  ?  ?  ?  ?  ?  ?  ?  ?  ?  ?  ?  ?  ?  ?  ?  ?  ?  ?  ?  ?  ?  ?  ?  ?  ?  ?  ?  ?  ?  ?  ?  ?  ?  ?  ?  ?  ?  ?  ?  ?  ?  ?  ?  ?  ?  ?  ?  ?  ?  ?  ?  ?  ?  ?  ?  ?  ?  ?  ?  ?  ?  ?  ?  ?  ?  ?  ?  ?  ?  ?  ?  ?  ?  ?  ?  ?  ?  ?  ?  ?  ?  ?  ?  ?  ?  ?  ?  ?  ?  ?  ?  ?  ?  ?  ?  ?  ?  ?  ?  ?  ?  ?  ? 
env-test_out-21	 ?  (fill in the answer)
env-test_out-22	 ?  (fill in the answer)
env-test_out-23	 ?  (fill in the answer)
env-test_out-24	 ?  (Please fill in the answer)
env-test_out-25	 ?  (fill in the answer)
env-test_out-26	 ?  ?  ?  ?  ?  ?  ?  ?  ?  ?  ?  ?  ?  ?  ?  ?  ?  ?  ?  ?  ?  ?  ?  ?  ?  ?  ?  ?  ?  ?  ?  ?  ?  ?  ?  ?  ?  ?  ?  ?  ?  ?  ?  ?  ?  ?  ?  ?  ?  ?  ?  ?  ?  ?  ?  ?  ?  ?  ?  ?  ?  ?  ?  ?  ?  ?  ?  ?  ?  ?  ?  ?  ?  ?  ?  ?  ?  ?  ?  ?  ?  ?  ?  ?  ?  ?  ?  ?  ?  ?  ?  ?  ?  ?  ?  ?  ?  ?  ?  ?  ?  ?  ?  ?  ?  ?  ?  ?  ?  ?  ?  ?  ?  ?  ?  ?  ?  ?  ?  ?  ?  ?  ?  ?  ? 
env-test_out-27	 ?  (fill in the answer)
env-test_out-28	 ?  (fill in the answer)
env-test_out-29	 ?  (Please fill in the answer)
env-test_out-30	 ?  ?  ?  ?  ?  ?  ?  ?  ?  ?  ?  ?  ?  ?  ?  ?  ?  ?  ?  ?  ?  ?  ?  ?  ?  ?  ?  ?  ?  ?  ?  ?  ?  ?  ?  ?  ?  ?  ?  ?  ?  ?  ?  ?  ?  ?  ?  ?  ?  ?  ?  ?  ?  ?  ?  ?  ?  ?  ?  ?  ?  ?  ?  ?  ?  ?  ?  ?  ?  ?  ?  ?  ?  ?  ?  ?  ?  ?  ?  ?  ?  ?  ?  ?  ?  ?  ?  ?  ?  ?  ?  ?  ?  ?  ?  ?  ?  ?  ?  ?  ?  ?  ?  ?  ?  ?  ?  ?  ?  ?  ?  ?  ?  ?  ?  ?  ?  ?  ?  ?  ?  ?  ?  ?  ? 
env-test_out-31	 ?  (fill in the blanks)
env-test_out-32	 ?  (fill in the answer)
env-test_out-33	 ?  (Please fill in the answer)
env-test_out-34	 ?  (Please fill in the answer)
env-test_out-35	 ?  (Please fill in the answer)
env-test_out-36	 ?  (Please fill in the answer)
env-test_out-37	 ?  (fill in the answer)
env-test_out-38	 ?  ?  ?  ?  ?  ?  ?  ?  ?  ?  ?  ?  ?  ?  ?  ?  ?  ?  ?  ?  ?  ?  ?  ?  ?  ?  ?  ?  ?  ?  ?  ?  ?  ?  ?  ?  ?  ?  ?  ?  ?  ?  ?  ?  ?  ?  ?  ?  ?  ?  ?  ?  ?  ?  ?  ?  ?  ?  ?  ?  ?  ?  ?  ?  ?  ?  ?  ?  ?  ?  ?  ?  ?  ?  ?  ?  ?  ?  ?  ?  ?  ?  ?  ?  ?  ?  ?  ?  ?  ?  ?  ?  ?  ?  ?  ?  ?  ?  ?  ?  ?  ?  ?  ?  ?  ?  ?  ?  ?  ?  ?  ?  ?  ?  ?  ?  ?  ?  ?  ?  ?  ?  ?  ?  ? 
env-test_out-39	 ?  (fill in the answer)
env-test_out-40	 ?  (fill in the answer)
env-test_out-41	 ?  (Please fill in the answer)
env-test_out-42	 ?  (fill in the answer)
env-test_out-43	 ?  (fill in the answer)
env-test_out-44	 ?  (fill in the blanks)
env-test_out-45	 ?  (fill in the answer)
env-test_out-46	 ?  (fill in the answer)
env-test_out-47	 ?  (Please fill in the answer)
env-test_out-48	 ?  (fill in the answer)
env-test_out-49	 ?  (Please fill in the answer)
env-test_out-50	 ?  (fill in the answer)
env-test_out-51	 ?  (fill in the answer)
env-test_out-52	 ?  ?  ?  ?  ?  ?  ?  ?  ?  ?  ?  ?  ?  ?  ?  ?  ?  ?  ?  ?  ?  ?  ?  ?  ?  ?  ?  ?  ?  ?  ?  ?  ?  ?  ?  ?  ?  ?  ?  ?  ?  ?  ?  ?  ?  ?  ?  ?  ?  ?  ?  ?  ?  ?  ?  ?  ?  ?  ?  ?  ?  ?  ?  ?  ?  ?  ?  ?  ?  ?  ?  ?  ?  ?  ?  ?  ?  ?  ?  ?  ?  ?  ?  ?  ?  ?  ?  ?  ?  ?  ?  ?  ?  ?  ?  ?  ?  ?  ?  ?  ?  ?  ?  ?  ?  ?  ?  ?  ?  ?  ?  ?  ?  ?  ?  ?  ?  ?  ?  ?  ?  ?  ?  ?  ? 
env-test_out-53	 ?  (Please fill in the answer)
env-test_out-54	 ?  (Please fill in the answer)
env-test_out-55	 ?  (Please fill in the answer)
env-test_out-56	 ?  (Please fill in the answer)
env-test_out-57	 ?  (fill in the answer)
env-test_out-58	 ?  ?  ?  ?  ?  ?  ?  ?  ?  ?  ?  ?  ?  ?  ?  ?  ?  ?  ?  ?  ?  ?  ?  ?  ?  ?  ?  ?  ?  ?  ?  ?  ?  ?  ?  ?  ?  ?  ?  ?  ?  ?  ?  ?  ?  ?  ?  ?  ?  ?  ?  ?  ?  ?  ?  ?  ?  ?  ?  ?  ?  ?  ?  ?  ?  ?  ?  ?  ?  ?  ?  ?  ?  ?  ?  ?  ?  ?  ?  ?  ?  ?  ?  ?  ?  ?  ?  ?  ?  ?  ?  ?  ?  ?  ?  ?  ?  ?  ?  ?  ?  ?  ?  ?  ?  ?  ?  ?  ?  ?  ?  ?  ?  ?  ?  ?  ?  ?  ?  ?  ?  ?  ?  ?  ? 
env-test_out-59	 ?  (Please fill in the answer)
env-test_out-60	 ?  (fill in the answer)
env-test_out-61	 ?  (fill in the answer)
env-test_out-62	 ?  (fill in the answer)
env-test_out-63	 ?  (fill in the answer)
env-test_out-64	 ?  ?  ?  ?  ?  ?  ?  ?  ?  ?  ?  ?  ?  ?  ?  ?  ?  ?  ?  ?  ?  ?  ?  ?  ?  ?  ?  ?  ?  ?  ?  ?  ?  ?  ?  ?  ?  ?  ?  ?  ?  ?  ?  ?  ?  ?  ?  ?  ?  ?  ?  ?  ?  ?  ?  ?  ?  ?  ?  ?  ?  ?  ?  ?  ?  ?  ?  ?  ?  ?  ?  ?  ?  ?  ?  ?  ?  ?  ?  ?  ?  ?  ?  ?  ?  ?  ?  ?  ?  ?  ?  ?  ?  ?  ?  ?  ?  ?  ?  ?  ?  ?  ?  ?  ?  ?  ?  ?  ?  ?  ?  ?  ?  ?  ?  ?  ?  ?  ?  ?  ?  ?  ?  ?  ? 
env-test_out-65	 ?  ?  ?  ?  ?  ?  ?  ?  ?  ?  ?  ?  ?  ?  ?  ?  ?  ?  ?  ?  ?  ?  ?  ?  ?  ?  ?  ?  ?  ?  ?  ?  ?  ?  ?  ?  ?  ?  ?  ?  ?  ?  ?  ?  ?  ?  ?  ?  ?  ?  ?  ?  ?  ?  ?  ?  ?  ?  ?  ?  ?  ?  ?  ?  ?  ?  ?  ?  ?  ?  ?  ?  ?  ?  ?  ?  ?  ?  ?  ?  ?  ?  ?  ?  ?  ?  ?  ?  ?  ?  ?  ?  ?  ?  ?  ?  ?  ?  ?  ?  ?  ?  ?  ?  ?  ?  ?  ?  ?  ?  ?  ?  ?  ?  ?  ?  ?  ?  ?  ?  ?  ?  ?  ?  ? 
env-test_out-66	 ?  (Please fill in the answer)
env-test_out-67	 ?  (fill in the answer)
env-test_out-68	 ?  (fill in the answer)
env-test_out-69	 ?  (Please fill in the answer)
env-test_out-70	 ?  ?  ?  ?  ?  ?  ?  ?  ?  ?  ?  ?  ?  ?  ?  ?  ?  ?  ?  ?  ?  ?  ?  ?  ?  ?  ?  ?  ?  ?  ?  ?  ?  ?  ?  ?  ?  ?  ?  ?  ?  ?  ?  ?  ?  ?  ?  ?  ?  ?  ?  ?  ?  ?  ?  ?  ?  ?  ?  ?  ?  ?  ?  ?  ?  ?  ?  ?  ?  ?  ?  ?  ?  ?  ?  ?  ?  ?  ?  ?  ?  ?  ?  ?  ?  ?  ?  ?  ?  ?  ?  ?  ?  ?  ?  ?  ?  ?  ?  ?  ?  ?  ?  ?  ?  ?  ?  ?  ?  ?  ?  ?  ?  ?  ?  ?  ?  ?  ?  ?  ?  ?  ?  ?  ? 
env-test_out-71	 ?  (fill in the answer)
env-test_out-72	 ?  (fill in the answer)
env-test_out-73	 ?  (Please fill in the answer)
env-test_out-74	 ?  (Please fill in the answer)
env-test_out-75	 ?  (Please fill in the answer)
env-test_out-76	 ?  (fill in the blanks)
env-test_out-77	 ?  (fill in the answer)
env-test_out-78	 ?  ?  ?  ?  ?  ?  ?  ?  ?  ?  ?  ?  ?  ?  ?  ?  ?  ?  ?  ?  ?  ?  ?  ?  ?  ?  ?  ?  ?  ?  ?  ?  ?  ?  ?  ?  ?  ?  ?  ?  ?  ?  ?  ?  ?  ?  ?  ?  ?  ?  ?  ?  ?  ?  ?  ?  ?  ?  ?  ?  ?  ?  ?  ?  ?  ?  ?  ?  ?  ?  ?  ?  ?  ?  ?  ?  ?  ?  ?  ?  ?  ?  ?  ?  ?  ?  ?  ?  ?  ?  ?  ?  ?  ?  ?  ?  ?  ?  ?  ?  ?  ?  ?  ?  ?  ?  ?  ?  ?  ?  ?  ?  ?  ?  ?  ?  ?  ?  ?  ?  ?  ?  ?  ?  ? 
env-test_out-79	 ?  (Please fill in the answer)
env-test_out-80	 ?  (fill in the answer)
env-test_out-81	 ?  (Please fill in the answer)
env-test_out-82	 ?  (fill in the answer)
env-test_out-83	 ?  (fill in the answer)
env-test_out-84	 ?  (Please fill in the answer)
env-test_out-85	 ?  (Please fill in the answer)
env-test_out-86	 ?  (Please fill in the answer)
env-test_out-87	 ?  ?  ?  ?  ?  ?  ?  ?  ?  ?  ?  ?  ?  ?  ?  ?  ?  ?  ?  ?  ?  ?  ?  ?  ?  ?  ?  ?  ?  ?  ?  ?  ?  ?  ?  ?  ?  ?  ?  ?  ?  ?  ?  ?  ?  ?  ?  ?  ?  ?  ?  ?  ?  ?  ?  ?  ?  ?  ?  ?  ?  ?  ?  ?  ?  ?  ?  ?  ?  ?  ?  ?  ?  ?  ?  ?  ?  ?  ?  ?  ?  ?  ?  ?  ?  ?  ?  ?  ?  ?  ?  ?  ?  ?  ?  ?  ?  ?  ?  ?  ?  ?  ?  ?  ?  ?  ?  ?  ?  ?  ?  ?  ?  ?  ?  ?  ?  ?  ?  ?  ?  ?  ?  ?  ? 
env-test_out-88	 ?  (Please fill in the answer)
env-test_out-89	 ?  (fill in the blanks)
env-test_out-90	 ?  (Please fill in the answer)
env-test_out-91	 ?  (Please fill in the answer)
env-test_out-92	 ?  (Please fill in the answer)
env-test_out-93	 ?  (Please fill in the answer)
env-test_out-94	 ?  (Please fill in the answer)
env-test_out-95	 ?  (fill in the answer)
env-test_out-96	 ?  (Please fill in the answer)
env-test_out-97	 ?  (Please fill in the answer)
env-test_out-98	 ?  (fill in the answer)
env-test_out-99	 ?  (Please fill in the answer)
