env-test_out-0	A wall at column 5 row 3 is blocking a path to the target object. A new closed door has been installed at column 7 row 9.
env-test_out-1	The target object has been hidden inside a box. There is a walkable passage at column 2 row 4. There is a pair of fireproof shoes at column 6 row 2.
env-test_out-2	The target object has been hidden inside a box. A new intact bridge has been constructed at column 5 row 5. A purple ball at column 1 row 8 is blocking a path to the target object.
env-test_out-3	The grid has been flipped along the vertical axis. The color of the target object has been changed to grey. The target object has been hidden inside a box. A new intact bridge has been constructed at column 2 row 4. There is a walkable passage at column 5 row 5.
env-test_out-4	The grid has been flipped along the vertical axis. The target object has been hidden inside a box. A lime ball at column 7 row 8 is blocking a path to the target object.
env-test_out-5	The target object has been hidden inside a box. The grid has been flipped along the vertical axis.
env-test_out-6	The target object has been hidden inside a box. There is a walkable passage at column 5 row 6. There is a pair of fireproof shoes at column 1 row 1.
env-test_out-7	A grey ball at column 5 row 7 is blocking a path to the target object. The target object has been hidden inside a box. There is a walkable passage at column 4 row 9.
env-test_out-8	A new closed door has been installed at column 7 row 5. The target object has been hidden inside a box. The color of the target object has been changed to lime.
env-test_out-9	A saffron ball at column 1 row 7 is blocking a path to the target object. The bridge at column 5 row 7 is no longer in the original state.
env-test_out-10	A new intact bridge has been constructed at column 6 row 5.
env-test_out-11	The bridge at column 5 row 8 is no longer in the original state. A grey ball at column 6 row 8 is blocking a path to the target object.
env-test_out-12	The target object has been hidden inside a box.
env-test_out-13	There is a walkable passage at column 7 row 4. A lime ball at column 4 row 8 is blocking a path to the target object.
env-test_out-14	A wall at column 9 row 4 is blocking a path to the target object. There is a walkable passage at column 4 row 9.
env-test_out-15	The grid has been flipped along the vertical axis. A new closed door has been installed at column 7 row 8. The target object has been hidden inside a box.
env-test_out-16	A grey ball at column 4 row 8 is blocking a path to the target object. The agent's starting location has been moved to column 1 row 7. There is a walkable passage at column 7 row 8.
env-test_out-17	The grid has been flipped along the vertical axis. The lava is safe to walk on. There is a walkable passage at column 1 row 3. There is a pair of fire-proof shoes at column 1 row 2.
env-test_out-18	The grid has been flipped along the vertical axis. The target object has been hidden inside a box.
env-test_out-19	The grid has been flipped along the vertical axis. A damaged bridge has been constructed at column 5 row 7. A lime ball at column 8 row 7 is blocking a path to the target object.
env-test_out-20	The target object has been hidden inside a box. There is a walkable passage at column 4 row 3.
env-test_out-21	The agent's starting location has been moved to column 7 row 1. The target object has been hidden inside a box. There is a walkable passage at column 3 row 6. A saffron ball at column 7 row 7 is blocking a path to the target object.
env-test_out-22	A new open door has been installed at column 5 row 6. The agent's starting location has been moved to column 4 row 6.
env-test_out-23	The target object has been hidden inside a box. The color of the target object has been changed to lime.
env-test_out-24	The agent's starting location has been moved to column 8 row 6. There is a walkable passage at column 6 row 7. There is a pair of fireproof shoes at column 5 row 1.
env-test_out-25	The color of the target object has been changed to lime. The target object has been hidden inside a box. A new damaged bridge has been constructed at column 5 row 8. A saffron ball at column 6 row 3 is blocking a path to the target object. There is a pair of fireproof shoes at column 2 row 5. There is a walkable passage at column 3 row 6.
env-test_out-26	The target object has been hidden inside a box. There is a walkable passage at column 2 row 6. A new damaged bridge has been constructed at column 5 row 6. There is a pair of fireproof shoes at column 5 row 2.
env-test_out-27	A new closed door has been installed at column 7 row 8. The target object has been hidden inside a box.
env-test_out-28	A new locked door has been installed at column 7 row 5. The door at column 5 row 7 is no longer in the original state.
env-test_out-29	The target object has been hidden inside a box. A new damaged bridge has been constructed at column 6 row 3. A purple ball at column 8 row 2 is blocking a path to the target object.
env-test_out-30	A new closed door has been installed at column 5 row 4. There is a walkable passage at column 4 row 6. A grey ball at column 3 row 5 is blocking a path to the target object. The target object has been hidden inside a box.
env-test_out-31	The agent's starting location has been moved to column 9 row 9. A new damaged bridge has been constructed at column 8 row 4. There is a walkable passage at column 9 row 4.
env-test_out-32	A new intact bridge has been constructed at column 5 row 7. There is a walkable passage at column 6 row 5. There is a pair of fire-proof shoes at column 1 row 5.
env-test_out-33	The agent's starting location has been moved to column 8 row 8. The bridge at column 6 row 8 is no longer in the original state. There is a walkable passage at column 7 row 5. A grey ball at column 5 row 8 is blocking a path to the target object.
env-test_out-34	A grey ball at column 7 row 2 is blocking a path to the target object. The lava is safe to walk on.
env-test_out-35	The agent's starting location has been moved to column 8 row 9. The target object has been hidden inside a box. There is a pair of fireproof shoes at column 5 row 4.
env-test_out-36	A purple ball at column 2 row 8 is blocking a path to the target object.
env-test_out-37	The grid has been flipped along the vertical axis. The target object has been hidden inside a box. A new damaged bridge has been constructed at column 7 row 6. A lime ball at column 9 row 6 is blocking a path to the target object. There is a pair of fireproof shoes at column 1 row 1.
env-test_out-38	The target object has been hidden inside a box. There is a pair of fireproof shoes at column 6 row 1. There is a walkable passage at column 7 row 5.
env-test_out-39	The target object has been hidden inside a box. The color of the target object has been changed to lime.
env-test_out-40	The grid has been flipped along the vertical axis. The target object has been hidden inside a box. A new closed door has been installed at column 2 row 6. The door at column 4 row 6 is no longer in the original state. There is a walkable passage at column 6 row 8.
env-test_out-41	The target object has been hidden inside a box. A new locked door has been installed at column 6 row 5. A grey ball at column 8 row 5 is blocking a path to the target object.
env-test_out-42	A new open door has been installed at column 4 row 7. The door at column 4 row 4 is no longer in the original state.
env-test_out-43	A lime ball at column 4 row 9 is blocking a path to the target object. There is a walkable passage at column 6 row 8. There is a pair of fire-proof shoes at column 3 row 1.
env-test_out-44	The target object has been hidden inside a box. A new closed door has been installed at column 9 row 5.
env-test_out-45	The target object has been hidden inside a box. A grey ball at column 5 row 8 is blocking a path to the target object.
env-test_out-46	A new closed door has been installed at column 4 row 4. The door at column 3 row 7 is no longer in the original state.
env-test_out-47	A new locked door has been installed at column 4 row 5. A new locked door has been installed at column 4 row 6. A saffron ball at column 2 row 8 is blocking a path to the target object.
env-test_out-48	The target object has been hidden inside a box. There is a walkable passage at column 6 row 8. A lime ball at column 8 row 5 is blocking a path to the target object.
env-test_out-49	The color of the target object has been changed to grey. The target object has been hidden inside a box.
env-test_out-50	The target object has been hidden inside a box. The color of the target object has been changed to saffron.
env-test_out-51	A new closed door has been installed at column 6 row 5. The target object has been hidden inside a box. The color of the target object has been changed to grey.
env-test_out-52	The target object has been hidden inside a box. The grid has been flipped along the vertical axis. A purple ball at column 8 row 5 is blocking a path to the target object. There is a pair of fire-proof shoes at column 9 row 3.
env-test_out-53	A new intact bridge has been constructed at column 8 row 3. The bridge at column 7 row 3 is no longer in the original state. The lava is safe to walk on.
env-test_out-54	The target object has been hidden inside a box. The bridge at column 4 row 6 is no longer in the original state. There is a walkable passage at column 5 row 6. A new intact bridge has been constructed at column 9 row 6.
env-test_out-55	The agent's starting location has been moved to column 1 row 8. A new damaged bridge has been constructed at column 7 row 4. A saffron ball at column 3 row 7 is blocking a path to the target object. A saffron ball at column 6 row 1 is blocking a path to the target object. A saffron ball at column 7 row 3 is blocking a path to the target object. There is a pair of fire-proof shoes at column 7 row 1. The target object has been hidden inside a box.
env-test_out-56	The target object has been hidden inside a box. A new damaged bridge has been constructed at column 2 row 6. There is a walkable passage at column 6 row 8.
env-test_out-57	A grey ball at column 8 row 9 is blocking a path to the target object. There is a walkable passage at column 8 row 3. The bridge at column 4 row 7 is no longer in the original state. There is a pair of fire-proof shoes at column 3 row 4. The lava is safe to walk on.
env-test_out-58	The agent's starting location has been moved to column 9 row 8. The color of the target object has been changed to lime. The bridge at column 8 row 6 is no longer in the original state. There is a walkable passage at column 6 row 9.
env-test_out-59	The agent's starting location has been moved to column 5 row 8. The target object has been hidden inside a box. A new damaged bridge has been constructed at column 7 row 7. There is a walkable passage at column 6 row 6. There is a pair of fireproof shoes at column 8 row 6.
env-test_out-60	A grey box at column 9 row 6 is blocking a path to the target object. There is a walkable passage at column 6 row 6. The target object has been hidden inside a box.
env-test_out-61	A new closed door has been installed at column 6 row 8. A lime ball at column 7 row 4 is blocking a path to the target object.
env-test_out-62	The target object has been hidden inside a box. The bridge at column 5 row 8 is no longer in the original state. The bridge at column 5 row 7 is no longer in the original state.
env-test_out-63	The color of the target object has been changed to lime. There is a walkable passage at column 5 row 7. The target object has been hidden inside a box.
env-test_out-64	The agent's starting location has been moved to column 1 row 4. The target object has been hidden inside a box. There is a pair of fireproof shoes at column 5 row 1. There is a walkable passage at column 5 row 3. The lava is safe to walk on.
env-test_out-65	A grey ball at column 6 row 2 is blocking a path to the target object. There is a walkable passage at column 5 row 3. The bridge at column 6 row 3 is no longer in the original state.
env-test_out-66	The grid has been flipped along the vertical axis. There is a walkable passage at column 6 row 6.
env-test_out-67	A new open door has been installed at column 8 row 6. A purple ball at column 8 row 5 is blocking a path to the target object.
env-test_out-68	A new closed door has been installed at column 3 row 6. The color of the target object has been changed to grey. The target object has been hidden inside a box. There is a walkable passage at column 4 row 6.
env-test_out-69	A new locked door has been installed at column 7 row 4. The door at column 6 row 5 is no longer in the original state. The target object has been hidden inside a box. There is a walkable passage at column 6 row 8.
env-test_out-70	The target object has been hidden inside a box. A new intact bridge has been constructed at column 7 row 8. A lime ball at column 4 row 4 is blocking a path to the target object.
env-test_out-71	A new locked door has been installed at column 8 row 3. There is a walkable passage at column 7 row 3. A purple ball at column 8 row 2 is blocking a path to the target object.
env-test_out-72	The target object has been hidden inside a box. A new locked door has been installed at column 8 row 6.
env-test_out-73	A grey ball at column 5 row 5 is blocking a path to the target object. The agent's starting location has been moved to column 3 row 7. There is a walkable passage at column 4 row 4.
env-test_out-74	The target object has been hidden inside a box. There is a walkable passage at column 6 row 7. There is a pair of fire-proof shoes at column 9 row 1.
env-test_out-75	A saffron ball at column 9 row 4 is blocking a path to the target object. The lava is safe to walk on.
env-test_out-76	A new closed door has been installed at column 3 row 7. The target object has been hidden inside a box.
env-test_out-77	The target object has been hidden inside a box. The lava is safe to walk on.
env-test_out-78	The target object has been hidden inside a box. There is a pair of fireproof shoes at column 1 row 9.
env-test_out-79	The target object has been hidden inside a box. The bridge at column 3 row 6 is no longer in the original state. There is a pair of fireproof shoes at column 8 row 5. There is a walkable passage at column 5 row 9.
env-test_out-80	The target object has been hidden inside a box. A purple ball at column 8 row 6 is blocking a path to the target object.
env-test_out-81	The grid has been flipped along the vertical axis. The target object has been hidden inside a box. A new damaged bridge has been constructed at column 4 row 7. There is a walkable passage at column 4 row 8.
env-test_out-82	The agent's starting location has been moved to column 7 row 7. There is a walkable passage at column 9 row 6. A new closed door has been installed at column 5 row 7.
env-test_out-83	The agent's starting location has been moved to column 7 row 9. There is a walkable passage at column 6 row 6.
env-test_out-84	A new closed door has been installed at column 8 row 3. A grey ball at column 8 row 2 is blocking a path to the target object.
env-test_out-85	A lime ball at column 8 row 9 is blocking a path to the target object. There is a walkable passage at column 7 row 9.
env-test_out-86	The grid has been flipped along the vertical axis. The color of the target object has been changed to saffron. The target object has been hidden inside a box. There is a walkable passage at column 6 row 6. A new damaged bridge has been constructed at column 3 row 5. There is a pair of fireproof shoes at column 9 row 4.
env-test_out-87	The bridge at column 3 row 5 is no longer in the original state. There is a wall at column 3 row 7.
env-test_out-88	The target object has been hidden inside a box. A new locked door has been installed at column 3 row 8. There is a walkable passage at column 3 row 9.
env-test_out-89	The target object has been hidden inside a box. The color of the target object has been changed to saffron. There is a pair of fireproof shoes at column 2 row 8.
env-test_out-90	The target object has been hidden inside a box. There is a pair of fireproof shoes at column 2 row 6. A new damaged bridge has been constructed at column 4 row 6. There is a walkable passage at column 7 row 3.
env-test_out-91	The color of the target object has been changed to purple. The target object has been hidden inside a box. The agent's starting location has been moved to column 3 row 9.
env-test_out-92	The grid has been flipped along the vertical axis. The target object has been hidden inside a box. There is a walkable passage at column 6 row 5.
env-test_out-93	The target object has been hidden inside a box. There is a walkable passage at column 5 row 8. There is a pair of fireproof shoes at column 8 row 1.
env-test_out-94	A new open door has been installed at column 4 row 7. A new closed door has been installed at column 4 row 5. There is a walkable passage at column 1 row 3. A lime ball at column 5 row 7 is blocking a path to the target object.
env-test_out-95	A new closed door has been installed at column 9 row 6. The color of the target object has been changed to grey. The target object has been hidden inside a box.
env-test_out-96	The target object has been hidden inside a box. The color of the target object has been changed to lime. A new intact bridge has been constructed at column 5 row 3. A lime ball at column 1 row 7 is blocking a path to the target object.
env-test_out-97	The target object has been hidden inside a box. A new damaged bridge has been constructed at column 4 row 6.
env-test_out-98	A new closed door has been installed at column 5 row 6. The target object has been hidden inside a box.
env-test_out-99	The target object has been hidden inside a box. The color of the target object has been changed to grey.
