env-test_out-0	 ?  (fill in the answer)
env-test_out-1	 The target object has been hidden inside a box. There is a walkable passage at column 2 row 4. The color of the target object has been changed to lime. The agent's starting location has been moved to column 5 row 1. There is a pair of fire-proof shoes at column 6 row 2.
env-test_out-2	 The target object has been hidden inside a box. The color of the target object has been changed to lime. There is a walkable passage at column 9 and row 5. The lime ball at column 9 and row 5 is blocking a path to the target object. The lime ball has disappeared. The agent's starting location has been moved to column 1 and row 6. There is a pair of fire-proof shoes at column 2 and row 1. The bridge at column 5 and row 5 is no longer in the original state. A new damaged bridge has been constructed at column 2 and row 3.
env-test_out-3	 ?  (fill in the answer)
env-test_out-4	 ?  (fill in the answer)
env-test_out-5	 the target object has been hidden inside a box. the color of the target object has been changed to saffron.
env-test_out-6	 The target object has been hidden inside a box. The color of the target object has been changed to purple. There is a walkable passage at column 5 row 6. The agent's starting location has been moved to column 1 row 7.
env-test_out-7	 ?  (Please fill in the answer)
env-test_out-8	 ?  (fill in the answer)
env-test_out-9	 (write your answer here)
env-test_out-10	 ?  (Please fill in the answer)
env-test_out-11	 The bridge at column 5 row 8 is no longer in the original state. The target object has been moved to column 3 row 8. There is a walkable passage at column 5 row 8. The color of the target object has been changed to lime.
env-test_out-12	 ?  (fill in the answer)
env-test_out-13	 (Please fill in the answer)
env-test_out-14	 ?  (fill in the answer)
env-test_out-15	 ?  (Please fill in the answer)
env-test_out-16	 The target object has been hidden inside a box. The color of the target object has been changed to grey. There is a walkable passage at column 7 row 8. The bridge at column 2 row 5 is no longer in the original state. There is a pair of fire-proof shoes at column 2 row 1.
env-test_out-17	 the agent's starting location has been moved to column 5 row 7. the target object has been moved one cell down. there is a walkable passage at column 1 row 3. there is a pair of fire-proof shoes at column 1 row 2.  the lava is safe to walk on.
env-test_out-18	 ?  (Please fill in the answer)
env-test_out-19	 The target object has been moved to column 1 row 8. The agent's starting location has been moved to column 1 row 6. There is a damaged bridge at column 5 row 7. The color of the target object has been changed to purple. The hammer has disappeared. There is a saffron ball at column 4 row 8. There is a lime ball at column 8 row 7. There is a lime ball at column 7 row 4. There is a lime ball at column 2 row 2. There is a lava pool at column 1 row 5. There is a lava pool at column 5 row 6. There is a lava pool at column 5 row 8.
env-test_out-20	 the target object has been hidden inside a box. the color of the target object has been changed to saffron.
env-test_out-21	 the target object has been hidden inside a box. the color of the target object has been changed to purple. there is a walkable passage at column 3 row 6. a new intact bridge has been constructed at column 5 row 7. the bridge at column 2 row 6 is no longer in the original state. there is a pair of fire-proof shoes at column 5 row 2. a saffron ball at column 5 row 3 is blocking a path to the target object. a saffron ball at column 7 row 7 is blocking a path to the target object.
env-test_out-22	 the door at column 5 row 6 is no longer in the original state. the target object has been moved to column 9 row 5.
env-test_out-23	 ?  (Please fill in the answer)
env-test_out-24	 ?  (Please fill in the answer)
env-test_out-25	 The target object has been hidden inside a box. The color of the target object has been changed to lime. There is a walkable passage at column 3 row 6. The bridge at column 5 row 8 is no longer in the original state. There is a pair of fire-proof shoes at column 2 row 5. The agent's starting location has been moved to column 6 row 4. The saffron ball at column 6 row 3 is blocking a path to the target object. The purple ball at column 9 row 8 is blocking a path to the target object.
env-test_out-26	 The target object has been hidden inside a box. The color of the target object has been changed to saffron.
env-test_out-27	 ?  (fill in the answer)
env-test_out-28	 ?  (fill in the answer)
env-test_out-29	 The target object has been hidden inside a box. The color of the target object has been changed to lime. There is a walkable passage at column 7 row 7. The bridge at column 6 row 3 is no longer in the original state.
env-test_out-30	 ?  (Please fill in the answer)
env-test_out-31	 ?  (fill in the answer)
env-test_out-32	 the target object has been hidden inside a box. the color of the target object has been changed to grey. 
env-test_out-33	 The bridge at column 6 row 8 is no longer in the original state. There is a walkable passage at column 7 row 5. The color of the target object has been changed to lime. The agent's starting location has been moved to column 8 row 8.
env-test_out-34	 (write your answer here)
env-test_out-35	 the target object has been hidden inside a box. the bridge at column 7 row 3 is no longer in the original state. there is a walkable passage at column 8 row 3. the agent's starting location has been moved to column 8 row 9. the lime ball at column 9 row 7 is blocking a path to the target object.
env-test_out-36	 ?  (fill in the answer)
env-test_out-37	 ?  (Please fill in the answer)
env-test_out-38	 the target object has been hidden inside a box. the color of the target object has been changed to grey. there is a walkable passage at column 7 row 5. a damaged bridge has been constructed at column 5 row 9. the agent's starting location has been moved to column 6 row 4. the fire-proof shoes were hidden inside a box. the fire-proof shoes are at column 6 row 1.  the lava is safe to walk on.  a purple ball at column 9 row 4 is blocking a path to the target object.  a saffron ball at column 1 row 1 is blocking a path to the target object.  a lime ball at column 1 row 3 is blocking a path to the target object.  a grey box at column 7 row 3 is blocking a path to the target object.  a grey box at column 7 row 8 is blocking a path to the target object.  a wall at column 9 row 6 is blocking a path to the target object.  an intact bridge at column 6 row 5 is blocking a path to the target object.  a damaged bridge at column 5 row 9
env-test_out-39	 The target object has been hidden inside a box. The color of the target object has been changed to lime. The agent's starting location has been moved to column 8 row 8.
env-test_out-40	 The door at column 8 row 6 is no longer in the original state. The target object has been hidden inside a box. There is a walkable passage at column 6 row 8. The color of the target object has been changed to grey. The saffron key was hidden inside a box. The door at column 2 row 6 is no longer in the original state. The agent's starting location has been moved to column 4 row 7.
env-test_out-41	 ?  (Please fill in the answer)
env-test_out-42	 ?  (fill in the answer)
env-test_out-43	 (write your answer here)
env-test_out-44	 ?  (fill in the blanks)
env-test_out-45	 ?  (fill in the answer)
env-test_out-46	 (write your answer here)
env-test_out-47	 The door at column 6 row 5 is no longer in the original state. The target object has been moved to column 2 row 8. The color of the target object has been changed to saffron. There is a walkable passage at column 3 row 3. The door at column 4 row 5 is no longer in the original state. The door at column 4 row 6 is no longer in the original state. 
env-test_out-48	 ?  (Please fill in the answer)
env-test_out-49	 The target object has been hidden inside a box. The color of the target object has been changed to purple. There is a walkable passage at column 5 row 6. The agent's starting location has been moved to column 3 row 9. The grid has been flipped along the vertical axis.
env-test_out-50	 ?  (fill in the answer)
env-test_out-51	 ?  (fill in the answer)
env-test_out-52	 ?  (Please fill in the answer)
env-test_out-53	 The bridge at column 7 row 3 is no longer in the original state. The color of the target object has been changed to purple. There is a walkable passage at column 7 row 2. The agent's starting location has been moved to column 2 row 4. There is a pair of fire-proof shoes at column 3 row 1. The grid has been flipped along the vertical axis.
env-test_out-54	 ?  (Please fill in the answer)
env-test_out-55	 The target object has been hidden inside a box. There is a damaged bridge at column 7 row 4. There is a walkable passage at column 6 row 4. The lava is safe to walk on. The agent's starting location has been moved to column 1 row 8. The color of the target object has been changed to lime.
env-test_out-56	 ?  (Please fill in the answer)
env-test_out-57	 The target object has been hidden inside a box. The agent's starting location has been moved to column 6 row 9. There is a walkable passage at column 8 row 3. The bridge at column 4 row 7 is no longer in the original state. There is a pair of fire-proof shoes at column 3 row 4.
env-test_out-58	 the target object has been hidden inside a box. the agent's starting location has been moved to column 9 row 8. there is a walkable passage at column 6 row 9. the bridge at column 8 row 6 is no longer in the original state. the color of the target object has been changed to lime. 
env-test_out-59	 The target object has been hidden inside a box. The agent's starting location has been moved to column 5 row 8. There is a walkable passage at column 6 row 6. The bridge at column 7 row 7 is no longer in the original state. There is a pair of fire-proof shoes at column 8 row 6.
env-test_out-60	 The door at column 6 row 5 is no longer in the original state. The target object has been hidden inside a box. There is a walkable passage at column 6 row 6. The color of the target object has been changed to purple.
env-test_out-61	 ?  (fill in the answer)
env-test_out-62	 The target object has been hidden inside a box. The bridge at column 5 row 7 is no longer in the original state. The bridge at column 5 row 8 is no longer in the original state. There is a walkable passage at column 5 row 6. There is a walkable passage at column 5 row 9. 
env-test_out-63	 The target object has been hidden inside a box. The color of the target object has been changed to saffron. The door at column 5 row 4 is no longer in the original state. The door at column 5 row 6 is no longer in the original state. There is a walkable passage at column 5 row 7. The agent's starting location has been moved to column 3 row 9. The purple ball at column 9 row 6 is blocking a path to the target object.
env-test_out-64	 ?????
```
the target object has been hidden inside a box. the color of the target object has been changed to lime. there is a walkable passage at column 5 row 3. there is a pair of fire-proof shoes at column 5 row 1. the bridge at column 4 row 3 is no longer in the original state. the bridge at column 6 row 6 is no longer in the original state. 
```
Final Answer: The final answer is the paragraph above. I hope it is correct.
env-test_out-65	 (write your answer here)
env-test_out-66	 ?  (fill in the answer)
env-test_out-67	 (write your answer here)
env-test_out-68	 ?  (fill in the answer)
env-test_out-69	 ?  (Please fill in the answer)
env-test_out-70	 ?  (fill in the answer)
env-test_out-71	 ?  (fill in the answer)
env-test_out-72	 ?  (Please fill in the answer)
env-test_out-73	 The target object has been moved to column 2 row 6. There is a walkable passage at column 4 row 4. The door at column 2 row 4 is no longer in the original state. The agent's starting location has been moved to column 3 row 7. 
env-test_out-74	 ?  (Please fill in the answer)
env-test_out-75	 The target object has been hidden inside a box. The color of the target object has been changed to lime. There is a walkable passage at column 4 row 3. There is a walkable passage at column 4 row 8. There is a walkable passage at column 5 row 3. There is a walkable passage at column 9 row 3. The bridge at column 4 row 7 is no longer in the original state. The saffron ball at column 9 row 4 is blocking a path to the target object.
env-test_out-76	 ?  (fill in the answer)
env-test_out-77	 The target object has been hidden inside a box. The color of the target object has been changed to purple.
env-test_out-78	 The target object has been hidden inside a box. The color of the target object has been changed to purple. There is a pair of fire-proof shoes at column 1 and row 9. The lava is safe to walk on.
env-test_out-79	 The bridge at column 3 row 6 is no longer in the original state. The target object has been hidden inside a box. There is a walkable passage at column 5 row 9. There is a pair of fire-proof shoes at column 8 row 5. The color of the target object has been changed to saffron.
env-test_out-80	 ?  (fill in the answer)
env-test_out-81	 The target object has been hidden inside a box. The color of the target object has been changed to lime. There is a walkable passage at column 4 row 8. The bridge at column 4 row 7 is no longer in the original state. The bridge at column 3 row 6 is no longer in the original state. The agent's starting location has been moved to column 2 row 7.
env-test_out-82	 The target object has been hidden inside a box. The color of the target object has been changed to grey. There is a walkable passage at column 9 and row 6. The door at column 5 and row 7 is no longer in the original state. A new open lime door has been installed at column 7 and row 6. The saffron key was hidden inside a box.
env-test_out-83	 ?  (Please fill in the answer)
env-test_out-84	 The target object has been hidden inside a box. The color of the target object has been changed to purple. The agent's starting location has been moved to column 8 row 1. There is a closed saffron door at column 6 row 5. There is a closed saffron door at column 8 row 3. The grey key was hidden inside a box. The grey ball at column 8 row 2 is blocking a path to the target object.
env-test_out-85	 the target object has been hidden inside a box. the color of the target object has been changed to saffron. a new closed grey door has been installed at column 3 row 5. a lime ball at column 8 row 9 is blocking a path to the target object.
env-test_out-86	 The target object has been hidden inside a box. The color of the target object has been changed to saffron. There is a walkable passage at column 6 row 6. The bridge at column 3 row 5 is no longer in the original state. There is a pair of fire-proof shoes at column 9 row 4. The agent's starting location has been moved to column 2 row 8.
env-test_out-87	 The target object has been hidden inside a box. The bridge at column 3 row 5 is no longer in the original state. The agent's starting location has been moved to column 8 row 7. There is a walkable passage at column 3 row 7. The color of the target object has been changed to grey.
env-test_out-88	 ?  (Please fill in the answer)
env-test_out-89	 The target object has been hidden inside a box. The color of the target object has been changed to saffron. There is a walkable passage at column 8 and row 8. The bridge at column 7 and row 6 is no longer in the original state. There is a pair of fire-proof shoes at column 2 and row 8.
env-test_out-90	 The target object has been hidden inside a box. The bridge at column 4 row 8 is no longer in the original state. The bridge at column 4 row 6 is no longer in the original state. There is a walkable passage at column 7 row 3. The agent's starting location has been moved to column 6 row 5. The fire-proof shoes have disappeared. The color of the target object has been changed to lime.
env-test_out-91	 The target object has been hidden inside a box. The color of the target object has been changed to grey. There is a walkable passage at column 5 row 8. The bridge at column 5 row 7 is no longer in the original state. The agent's starting location has been moved to column 3 row 9. There is a pair of fire-proof shoes at column 8 row 9. The grid has been flipped along the vertical axis.
env-test_out-92	 ?  (fill in the answer)
env-test_out-93	 The target object has been hidden inside a box. The color of the target object has been changed to lime. There is a walkable passage at column 5 row 8. The agent's starting location has been moved to column 1 row 8. The purple ball at column 8 row 8 is blocking a path to the target object. The purple ball at column 4 row 7 is blocking a path to the target object. The purple ball at column 6 row 7 is blocking a path to the target object. There is a pair of fire-proof shoes at column 8 row 1. A new intact bridge has been constructed at column 1 row 5. The bridge at column 5 row 7 is no longer in the original state.
env-test_out-94	 The target object has been hidden inside a box. The color of the target object has been changed to grey. There is a walkable passage at column 1 and row 3. The door at column 4 row 5 is no longer in the original state. The door at column 4 row 7 is no longer in the original state. A new closed saffron door has been installed at column 4 row 5. A new open saffron door has been installed at column 4 row 7. The agent's starting location has been moved to column 3 row 4. 
env-test_out-95	 ?  (fill in the answer)
env-test_out-96	 ?  (Please fill in the answer)
env-test_out-97	 ?  (Please fill in the answer)
env-test_out-98	 ?  (fill in the answer)
env-test_out-99	 The target object has been hidden inside a box. The color of the target object has been changed to lime. There is a walkable passage at column 5 and row 8.
